XXXXXXXXXX
XX  YY  XX
XXXXXXXXXX
ZZ  ZZ  ZZ
YYYYYYYYYY
