XXXXXXXXXX
XXXXXXXXXX
YYYYYYYYYY
ZZZZZZZZZZ
XXXXXXXXXX
