XXXXXXXXXX
X Y  Z  X 
XXXXXXXXXX
Z Y  X  Z 
XXXXXXXXXX